10 20
|------------------|
|@..|.P.F....|.....|
|..-|........|-....|
|.....F.........F..|
|-.................|
|.......--......F..| 
|..................|
|.......|.....P....|
|..F....|..........|
|------------------|